她	ta	1
趣	qut
二	era
壬	rfp
右	yzu
时	uio
础	iuu
噢	ook
醅	pwy
吖	aak
鸽	ger
盉	heh
玖	jqw
渴	ked
崽	zdu
孝	xnl
丛	csr
遮	vez
叭	bak
倪	nir
嘛	mak
肮	aho
袄	aop
爸	baf
宝	bcb
栟	bfm
泵	bgu
邦	bhf
毕	bib
病	bkb
摽	bnf
泊	bod
卑	bwp
曹	ccc
嶒	cgu
伧	chr
瓷	cid
惭	cjx
锉	coj
存	cyu
德	der
党	dhx
堤	dit
儋	djr
疔	dkb
簟	dmv
惰	dox
迭	dpz
恫	dsx
怼	dvy
囤	dyk
锋	fgj
邡	fhf
斐	fwf
膏	gcw
盖	gdy
冈	ghk
玕	gjw
官	grb
骨	gug
簋	gvv
孩	hdz
盒	her
桁	hgm
颔	hjr
荒	hlc
惑	hog
擐	hrf
纮	hss
祜	hup
徽	hvr
浑	hyd
厚	hzi
叉	iay
珵	igw
嗤	iik
颤	ijw
惙	iox
涌	isd
琡	iuw
圌	ivk
近	jbz
及	jip
奖	jll
检	jmm
嚼	jnk
揭	jpf
九	jqp
眷	jrj
冏	jsk
惧	jux
架	jxl
畯	jyt
犒	kcn
磕	keu
扛	khf
砍	kju
𫛭	klq
括	kof
骷	kug
喇	lak
檩	lbm
耢	lcl
坜	lit
领	lkr
晾	llo
络	los
烈	lpd
溜	lqd
鹭	luz
檑	lwm
娄	lzm
嘛	mak
檬	mgm
密	mib
万	moa
湄	mwd
哪	nek
昵	nio
嬢	nln
袅	nnn
弩	nun
噢	ook
鸥	ouq
贫	pbf
排	pdf
抨	pgf
膀	pho
披	pif
爿	pjv
飘	pnx
酺	puy
期	qic
鲭	qky
骞	qmb
璆	qqw
佺	qrr
穹	qsb
曲	quk
忍	rfr
瓤	rhy
鄀	roc
冗	rsb
嬬	run
搔	scf
塞	sdb
涩	sed
泗	sid
蔌	suc
碎	svu
飕	szf
淘	tcd
汰	tdd
剔	tio
谭	tjy
托	tof
嗵	tsk
吐	tuk
饨	tyu
嗄	uak
沈	ufd
升	ugp
食	uir
苫	ujc
霜	uly
疏	uuv
招	vcf
谪	vey
砧	vfu
吱	vik
状	vll
卓	vob
珠	vuw
咒	vzk
闻	wfm
瓮	wgg
挝	wof
五	wua
辛	xbl
夕	xip
形	xkk
相	xlm
嫌	xmn
箫	xnv
休	xqr
凶	xsk
削	xtx
许	xuy
荀	xyc
吖	yak
吟	ybk
爻	ycx
杨	yhm
咦	yik
堰	yjt
鹰	ykg
唷	yok
咏	ysk
竽	yuv
繇	yzv
咂	zak
兹	zib
酂	zjn
作	zor
宗	zsb

唉	aiku/
碍	aiuc/
砹	aiux/
毐	aitm/
嗳	aiky/
蔼	aicr/
霭	aiyr/
嗌	aikm/
皑	aibj/
叆	aiyy/
案	anbm/
胺	anon/
鞍	angn/
盦	anrm/
垵	antn/
犴	anqg/
𩽾	anyn/
敖	aofw/
鳌	aofy/
螯	aofi/
拗	aofl/
獒	aofq/
鏊	aofj/
鏖	aolj/
骜	aofm/
奡	aobl/
聱	aofe/
嶅	aofu/
拔	bafy/
罢	basq/
扒	bafb/
捌	bafd/
魃	bagy/
鲃	bayb/
鲅	bayy/
朳	bamb/
菝	bacy/
殡	bbdb/
濒	bbdy/
摈	bbfb/
玢	bbwf/
槟	bbmb/
抱	bcfb/
堡	bcrt/
煲	bcrh/
暴	bcou/
刨	bcbd/
褒	bcym/
胞	bcob/
苞	bccb/
葆	bccm/
炮	bchb/
鸨	bcbn/
雹	bcyb/
龅	bcvb/
趵	bczu/
掰	bduu/
捭	bdfu/
伯	bdrb/
夯	bfdl/
迸	bgzk/
榜	bhmf/
梆	bhme/
搒	bhff/
鼻	bizw/
壁	biut/
避	bizx/
弊	bixc/
璧	biuy/
鄙	bike/
敝	bixw/
毙	bibb/
匕	bipv/
俾	biru/
痹	bibw/
弼	bigb/
吡	bikb/
髀	bigu/
妣	binb/
滗	bidm/
箅	bivw/
沘	bidb/
芘	bicb/
裨	bipu/
嬖	biun/
萆	bicu/
屄	biub/
篦	bivb/
邲	bibe/
薜	bicx/
辟	biux/
荸	bicz/
珌	biwb/
佖	birb/
跸	bizu/
筚	bivu/
佛	birf/
觱	biwy/
馝	bihb/
鲾	biyt/
坒	bibt/
拌	bjfb/
斑	bjww/
扮	bjff/
扳	bjfy/
癍	bjbw/
攽	bjfw/
柈	bjmb/
瘢	bjbu/
𨭉	bjwj/
屏	bkuk/
秉	bkqr/
槟	bkmb/
邴	bkbe/
栟	bkmk/
遍	bmzc/
辨	bmxl/
煸	bmhc/
卞	bmwb/
弁	bmsc/
辫	bmxs/
忭	bmxb/
碥	bmuc/
萹	bmcc/
𨚕	bmse/
杓	bnmu/
骉	bnmm/
幖	bnju/
熛	bnhu/
镳	bnjh/
飑	bnfb/
俵	bnry/
脿	bnoy/
拨	bofy/
搏	bofc/
钵	bojb/
勃	boul/
亳	bowq/
孛	bouz/
柏	bomb/
钹	bojy/
渤	bodl/
僰	bour/
擘	bouu/
镈	bojc/
浡	bodz/
嶓	bout/
菠	bocp/
舶	bovb/
膊	booc/
哱	bokz/
簸	bovp/
鹁	boun/
踣	bozk/
砵	boub/
蕃	boct/
趵	bozu/
檗	boum/
艴	bofb/
礴	bouc/
欂	bomc/
𬭛	bojp/
鳖	bpxy/
蹩	bpxz/
癿	bpbv/
簿	buvc/
卜	buld/
哺	bukf/
瓿	bulw/
埔	butf/
埗	butu/
𬷕	bufn/
贝	bwkr/
辈	bwfi/
邶	bwbe/
孛	bwuz/
惫	bwwx/
碚	bwuk/
褙	bwpo/
琲	bwwf/
鹎	bwpn/
棓	bwmk/
椑	bwmu/
糒	bwmy/
臂	bwuo/
鐾	bwuj/
鞁	bwgp/
糙	ccmk/
嘈	ccko/
芔	cccc/
蔡	cdcu/
彩	cdcp/
苍	chcv/
磁	ciuy/
辞	ciux/
雌	civv/
慈	cibx/
泚	cidb/
疵	cibb/
差	ciyg/
茈	cicb/
兹	ciby/
佽	cirq/
鹚	cibn/
莿	cicd/
𫚖	civy/
残	cjdj/
粲	cjdm/
䅟	cjhp/
挫	cofr/
措	cofo/
撮	cofy/
嵯	coug/
鹾	cobg/
撺	crfi/
镩	crji/
枞	csmr/
璁	cswx/
苁	cscr/
徂	curq/
卒	cuwu/
毳	cvmm/
悴	cvxu/
榱	cvmv/
漼	cvdv/
搭	dafk/
嗒	dakk/
跶	dazd/
靼	dagd/
笪	davd/
溚	dadk/
鿎	daud/
𫟼	dajd/
纛	dcfx/
蹈	dczj/
捯	dcfd/
忉	dcxd/
舠	dcvd/
待	ddrc/
贷	ddrb/
袋	ddry/
黛	ddrh/
岱	ddru/
迨	ddzk/
呔	ddkt/
绐	ddsk/
大	ddar/
垈	ddrt/
凳	dgbj/
戥	dgog/
嶝	dgub/
菪	dhcu/
𣗋	dhmx/
弟	dibd/
递	dizd/
笛	divy/
氐	diud/
骶	digu/
邸	diue/
碲	diuj/
鞮	digz/
籴	dirm/
菂	dicu/
砥	diuu/
涤	didm/
荻	dich/
诋	diyu/
娣	dind/
柢	dimu/
杕	dimd/
坻	ditu/
踶	dizz/
媂	dinj/
提	difz/
玓	diwu/
蹢	dizg/
𤧛	diwj/
𬱖	diyy/
旦	djoa/
啖	djkh/
掸	djfu/
澹	djdk/
疍	djzd/
殚	djdu/
聃	djer/
憺	djxk/
膻	djod/
眈	djoe/
瘅	djbu/
赕	djbh/
郸	djbe/
疸	djbd/
𫢸	djru/
腚	dkoz/
锭	dkjz/
啶	dkkz/
酊	dkyd/
殿	dmuu/
颠	dmuy/
掂	dmfv/
癫	dmby/
奠	dmbd/
靛	dmfz/
淀	dmdz/
癜	dmbu/
琔	dmwz/
叼	dnkd/
雕	dnkv/
刁	dnva/
鲷	dnyk/
碉	dnuk/
铫	dnjv/
铞	dnjj/
汈	dndd/
朵	dojm/
铎	dojf/
踱	dozy/
咄	doki/
埵	dott/
哚	dokm/
饳	doui/
㙍	doty/
谍	dpym/
蹀	dpzm/
垤	dptt/
𫶇	dpuj/
耑	drue/
簖	drvj/
冻	dsdd/
鸫	dsdn/
硐	dsuk/
岽	dsud/
胨	dsod/
睹	duoo/
蠹	dugi/
犊	dund/
渎	dudd/
椟	dumd/
阇	dumo/
厾	duvq/
黩	duld/
𬭊	dujt/
遁	dyzo/
墩	dytw/
趸	dywz/
镦	dyjw/
蹾	dyzw/
砘	dyut/
窦	dzbd/
讹	eeyb/
鳄	eeyk/
鄂	eeke/
蛾	eeiw/
颚	eeky/
莪	eecw/
轭	eeiv/
噩	eewk/
屙	eeuk/
鹗	eekn/
峨	eeuw/
锷	eejk/
垩	eeyt/
婀	eenk/
哦	eekw/
苊	eecv/
𫫇	eekx/
洱	erde/
鲕	erye/
陑	eree/
耏	erep/
垡	fart/
粪	ffmg/
焚	ffmh/
奋	ffdt/
偾	ffrb/
棻	ffcm/
鲼	ffyb/
棼	ffmf/
瀵	ffdg/
翂	ffxf/
坋	fftf/
𣸣	ffdb/
凤	fgjy/
丰	fgsl/
蜂	fgif/
沣	fgdf/
酆	fgue/
砜	fguf/
崶	fguc/
赗	fgbo/
鲂	fhyf/
肪	fhof/
牥	fhnf/
范	fjcv/
番	fjct/
帆	fjjf/
樊	fjmd/
矾	fjuf/
幡	fjjt/
燔	fjht/
氾	fjdv/
蘩	fjcx/
蹯	fjzt/
墦	fjtt/
𬸪	fjcn/
复	fupw/
夫	fuer/
父	fubx/
弗	fugl/
赋	fubv/
斧	fufj/
伏	furq/
敷	fufw/
腹	fuow/
釜	fufb/
傅	furc/
浮	fudz/
拂	fuff/
腐	fugr/
俘	furz/
辐	fuit/
腑	fuoc/
孚	fuvz/
肤	fuof/
阜	fupu/
佛	furf/
芣	fucb/
凫	funj/
苻	fucc/
祓	fupy/
鄜	fule/
涪	fudk/
郛	fuve/
黻	fuyy/
簠	fuvm/
拊	fufc/
绂	fusy/
莩	fucz/
赙	fubc/
宓	fubb/
茯	fucq/
稃	fuhz/
怫	fuxf/
趺	fuzf/
蝮	fuiw/
袱	fupq/
罘	fusb/
洑	fudq/
匐	fubt/
鲋	fuyc/
榑	fumc/
茀	fucf/
芾	fucj/
菔	fucy/
咐	fukc/
幞	fujf/
蚨	fuif/
滏	fudb/
韨	fuwy/
琈	fuwz/
讣	fuyb/
蜉	fuiz/
绋	fusf/
砆	fuuf/
垺	futz/
㕮	fukf/
㳇	fudf/
𫖯	fuvy/
肥	fwob/
吠	fwkq/
啡	fwkf/
腓	fwof/
蜚	fwfi/
淝	fwdb/
翡	fwfx/
朏	fwoi/
鲱	fwyf/
芾	fwcj/
棐	fwfm/
剕	fwfd/
篚	fwvf/
𬴂	fwmf/
噶	gakr/
咖	gakk/
旮	gajo/
锆	gcjk/
郜	gcne/
槔	gcmu/
羔	gcyh/
槁	gcmk/
筶	gcvk/
钙	gdjg/
𬮿	gdej/
歌	gekq/
咯	gekk/
阁	gemk/
镉	gejg/
革	gecu/
嗝	gekg/
胳	geok/
盖	geym/
疙	gebv/
饹	geuk/
合	gerk/
虼	geiv/
仡	gerv/
塥	getg/
赓	gggb/
鲠	ggyg/
鹒	gggn/
罡	ghsv/
矼	ghug/
扛	ghfg/
冮	ghdg/
㭎	ghmx/
鿍	ghtf/
柑	gjmg/
苷	gjcg/
橄	gjmw/
鳡	gjyx/
酐	gjyg/
坩	gjtg/
泔	gjdg/
旰	gjog/
澉	gjdw/
掴	gkfy/
洸	gldg/
椁	gomz/
馃	goug/
呙	gokn/
帼	gojy/
蜾	goig/
埚	gotn/
𬇹	gody/
冠	grbc/
贯	grmb/
毌	grml/
掼	grfb/
瓘	grwv/
鳏	gryx/
筦	grvy/
涫	grdl/
莞	grcy/
鳤	gryl/
蒄	grcc/
宫	gsbk/
功	gsgl/
汞	gsgu/
贡	gsgb/
恭	gsgx/
巩	gsgf/
䢼	gsge/
硔	gsug/
蛊	guim/
咕	gukg/
瞽	guto/
菰	gucg/
辜	gugx/
觚	gudg/
榖	gutu/
酤	guyg/
锢	gujg/
轱	guig/
嘏	gugy/
汩	gudo/
鹘	gugn/
崮	guug/
牯	gung/
羖	guyu/
鹄	gunn/
臌	guov/
痼	gubg/
馉	guuo/
牿	gunk/
堌	gutg/
蓇	guco/
瀔	gudu/
𦙶	guog/
桂	gvmt/
珪	gvwt/
刿	gvud/
邽	gvte/
鲑	gvyt/
桧	gvmy/
鳜	gvyq/
鬶	gvfg/
宄	gvbj/
皈	gvby/
炅	gvoh/
姽	gvnv/
筀	gvvt/
剐	gxkd/
鸹	gxun/
衮	gyyg/
钩	gzjg/
购	gzbg/
彀	gztu/
枸	gzmj/
姤	gznk/
雊	gzjv/
笱	gzvj/
句	gzbk/
嚎	hcku/
毫	hcwm/
蚝	hcim/
蒿	hcck/
皞	hcbu/
濠	hcdu/
灏	hcdy/
鄗	hcwe/
颢	hcoy/
淏	hcdt/
嚆	hckk/
嗐	hdkk/
咳	hdkr/
合	herk/
呵	hekk/
阖	hemm/
褐	hepr/
颌	hery/
郃	here/
涸	hedg/
壑	hebt/
貉	hevk/
鹖	heon/
吓	hekx/
龢	herh/
熇	hehk/
阂	hemr/
菏	heck/
隺	hebv/
鞨	hegr/
𬌗	heyk/
珩	hgwd/
鸻	hgrn/
行	hgrd/
沆	hhdj/
汗	hjdg/
函	hjku/
焓	hjhk/
罕	hjbg/
涵	hjdu/
憾	hjxx/
翰	hjux/
瀚	hjdx/
晗	hjok/
捍	hjfg/
邗	hjge/
暵	hjot/
顸	hjgy/
撖	hjfw/
虷	hjig/
浛	hjdk/
㘎	hjkw/
崡	hjuu/
嵅	hjuk/
蔊	hjcg/
篁	hlvw/
幌	hljg/
恍	hlxg/
潢	hldb/
湟	hldw/
肓	hlwo/
锽	hljw/
鳇	hlyw/
惶	hlxw/
蟥	hlib/
癀	hlbb/
瑝	hlww/
㿠	hlbg/
𨱑	hljb/
豁	hobg/
伙	horh/
藿	hocv/
钬	hojh/
濩	hody/
夥	hogx/
嚄	hoky/
劐	hocd/
漷	hode/
佸	horu/
锪	hojx/
㸌	hohv/
欢	hryq/
涣	hrdd/
圜	hrky/
郇	hrbe/
鲩	hryy/
宦	hrbi/
逭	hrzl/
缳	hrsy/
鹮	hrsn/
澴	hrdy/
痪	hrbd/
漶	hrdx/
镮	hrjy/
㬊	hroy/
荁	hrcd/
𤩽	hrwq/
虹	hsig/
洪	hsdg/
泓	hsds/
吽	hskn/
蕻	hscg/
訇	hsbk/
唝	hskb/
谼	hsgg/
𬭎	hsjs/
户	hudu/
和	huhk/
沪	hudh/
弧	hugg/
唬	hukj/
斛	hudd/
核	humr/
縠	hutu/
瓠	hudg/
煳	huho/
瑚	huwo/
扈	huhb/
烀	huhh/
怙	huxg/
鹘	hugn/
唿	hukx/
鹱	huny/
鳠	huyy/
琥	huwj/
囫	hukw/
醐	huyo/
槲	humd/
戽	huhd/
淴	hudx/
嫭	hunh/
轷	huih/
浒	hudw/
猢	huqo/
昈	huoh/
喙	hvku/
慧	hvfx/
恢	hvxh/
秽	hvhx/
麾	hvgm/
卉	hvuc/
诲	hvym/
晦	hvom/
荟	hvcy/
洄	hvdk/
蕙	hvcx/
翚	hvxi/
彗	hvfe/
蛔	hvik/
珲	hvwi/
翙	hvux/
浍	hvdy/
咴	hvkh/
哕	hvkx/
诙	hvyh/
蟪	hvix/
桧	hvmy/
溃	hvdb/
硊	hvuv/
㧑	hvfw/
烠	hvho/
𬤝	hvyx/
𬭬	hvje/
华	hxru/
骅	hxmu/
觟	hxdt/
溷	hydu/
馄	hyub/
诨	hyyi/
碈	hyuo/
候	hzru/
喉	hzku/
垕	hzit/
逅	hzzk/
郈	hzie/
茬	iact/
搽	iafm/
岔	iafu/
槎	iamg/
檫	iamu/
杈	iami/
诧	iayq/
锸	iajj/
馇	iaud/
喳	iakd/
𥻗	iamd/
嘲	icko/
焯	ichu/
豺	idvc/
撤	iefw/
砗	ieui/
嗔	ifkb/
谌	ifyb/
瞋	ifob/
忱	ifxe/
榇	ifmm/
疢	ifbh/
棽	ifmv/
煁	ifhb/
郴	ifme/
程	ighw/
秤	ighp/
丞	igla/
埕	igtw/
枨	igmi/
骋	igmk/
琤	igwy/
蛏	igit/
酲	igyw/
偁	igrr/
噌	igko/
澂	igdw/
赪	igib/
珹	igwi/
塍	igot/
柽	igmt/
憕	igxb/
晟	igoi/
铛	igje/
尝	ihxy/
昌	ihoo/
敞	ihxw/
怅	ihxi/
鬯	ihkb/
倡	ihro/
嫦	ihnj/
氅	ihxm/
伥	ihri/
鲳	ihyo/
徜	ihrk/
菖	ihco/
鲿	ihyy/
惝	ihxk/
翅	iivx/
敕	iiuw/
豉	iidv/
叱	iikb/
笞	iivk/
哧	iiki/
饬	iiul/
魑	iign/
褫	iipj/
摛	iifn/
鸱	iiun/
瘛	iibx/
眵	iiox/
漦	iiwu/
墀	iitn/
篪	iivj/
傺	iiru/
踟	iizk/
茌	iict/
胣	iioy/
痓	iibt/
搀	ijfd/
蟾	ijik/
澶	ijdd/
镡	ijju/
谄	ijyj/
襜	ijpk/
刬	ijjd/
辿	ijzu/
巉	ijut/
瀍	ijdt/
羼	ijuy/
潺	ijdz/
孱	ijuz/
梴	ijmv/
冁	ijby/
韂	ijgk/
骣	ijmz/
镵	ijjt/
搋	ikfj/
疮	ilbv/
逴	iozu/
喘	irke/
忡	isxv/
艟	isvl/
珫	iswy/
漴	isdu/
㳘	isdy/
褚	iupo/
杵	iumw/
畜	iuxt/
雏	iudv/
橱	iumc/
刍	iude/
楮	iumo/
矗	iuuq/
滁	iudm/
俶	iury/
樗	iumk/
憷	iuxz/
斶	iuji/
摴	iufk/
蜍	iuim/
蹰	iuzc/
䢺	iuie/
濋	iudz/
𬺓	iuvz/
棰	ivmt/
蠢	iyii/
唇	iyik/
蝽	iyio/
瑃	iywo/
䲠	iyyo/
筹	izvc/
稠	izhk/
俦	izrc/
雠	izry/
犨	izrn/
踌	izzc/
侴	izrd/
椆	izmk/
金	jbrb/
今	jbrv/
尽	jbid/
锦	jbjj/
浸	jbdy/
谨	jbyw/
槿	jbmw/
矜	jbmv/
襟	jbpu/
瑨	jbwo/
溍	jbdo/
噤	jbku/
觐	jbcj/
祲	jbpy/
荩	jbcd/
浕	jbdd/
殣	jbdw/
珒	jbwy/
廑	jbgw/
琎	jbwj/
卺	jblv/
既	jigw/
鸡	jiyn/
极	jimj/
系	jipx/
继	jism/
计	jiyu/
技	jifv/
给	jisk/
击	jifk/
寂	jiby/
纪	jisj/
积	jihv/
暨	jigd/
箕	jivb/
激	jidw/
脊	jiro/
济	jidq/
疾	jibu/
叽	jikj/
冀	jibg/
饥	jiuj/
绩	jisb/
棘	jiuu/
藉	jico/
蓟	jicd/
稷	jihw/
汲	jidj/
妓	jinv/
殛	jida/
稽	jiho/
赍	jiub/
霁	jiyq/
鲫	jiye/
圾	jitj/
奇	jidk/
伎	jirv/
髻	jiek/
伋	jirj/
嵴	jiuo/
偈	jirr/
畸	jitk/
嫉	jinu/
讥	jiyj/
畿	jigt/
罽	jisd/
笈	jivj/
骥	jimg/
唧	jike/
嵇	jihu/
笄	jivk/
齑	jiqj/
乩	jivv/
麂	jilj/
戢	jige/
洎	jidz/
芰	jicv/
跽	jizx/
楫	jime/
蕺	jice/
姞	jink/
荠	jicq/
垍	jitz/
屐	jiuv/
跻	jizq/
缉	jise/
悸	jixz/
剞	jidd/
佶	jirk/
惎	jicx/
漈	jidu/
耤	jilo/
瘠	jibo/
芨	jicj/
蹐	jizo/
蒺	jicu/
墼	jiit/
鹡	jirn/
虮	jiij/
㴔	jidx/
枅	jimk/
𪟝	jifl/
𫌀	jipb/
𫓯	jijt/
𫓹	jijb/
𬯀	jieq/
𬶨	jigy/
竞	jklx/
颈	jkjy/
警	jkck/
茎	jkcj/
荆	jkcd/
靖	jklo/
睛	jkoo/
菁	jkco/
璟	jkwx/
粳	jkmg/
胫	jkoj/
劲	jkjl/
旌	jkfu/
丼	jkjd/
泾	jkdj/
儆	jkrw/
憬	jkxx/
倞	jkrx/
靓	jkfj/
璥	jkww/
鼱	jkjo/
猄	jkqx/
䴖	jkfn/
竫	jkly/
酱	jlly/
姜	jlyn/
浆	jllu/
桨	jllm/
疆	jlgj/
缰	jlsj/
鳉	jlyc/
豇	jldg/
洚	jldf/
强	jlgi/
耩	jllr/
弶	jlgx/
茳	jlcg/
煎	jmbh/
剪	jmbd/
简	jmvo/
舰	jmvj/
贱	jmbj/
健	jmry/
歼	jmdq/
渐	jmdj/
荐	jmcz/
拣	jmfd/
坚	jmlt/
鉴	jmlj/
僭	jmro/
蹇	jmbz/
涧	jmdo/
践	jmzj/
翦	jmbx/
菅	jmcl/
艰	jmyg/
俭	jmrq/
腱	jmoy/
柬	jmur/
锏	jmjo/
缣	jmsj/
謇	jmbk/
戋	jmga/
湔	jmdd/
犍	jmny/
蒹	jmcj/
槛	jmmm/
搛	jmfj/
踺	jmzy/
鲣	jmyt/
鹣	jmjn/
楗	jmmy/
暕	jmoj/
枧	jmmj/
谫	jmyd/
饯	jmuj/
鞯	jmgz/
趼	jmzk/
牮	jmrn/
鳒	jmyj/
胶	jnof/
浇	jndw/
绞	jnsf/
轿	jnil/
骄	jnml/
礁	jnuh/
蛟	jnif/
饺	jnuf/
徼	jnrf/
皎	jnbf/
郊	jnwe/
湫	jndh/
酵	jnyz/
鹪	jnrn/
滘	jndk/
校	jnmf/
姣	jnnf/
醮	jnyh/
皦	jnbw/
璬	jnww/
艽	jncj/
茭	jncf/
峤	jnul/
侥	jnrw/
皭	jnbc/
斠	jnfd/
藠	jncb/
噍	jnkh/
僬	jnrh/
恔	jnxf/
䴔	jnwn/
街	jprt/
戒	jpgc/
介	jprl/
洁	jpdk/
捷	jpfz/
芥	jpcj/
藉	jpco/
诘	jpyk/
桔	jpmk/
价	jprj/
颉	jpty/
孑	jpla/
疖	jpbe/
碣	jpur/
诫	jpyc/
婕	jpnz/
疥	jpbj/
絜	jpfx/
劼	jptl/
拮	jpfk/
檞	jpmn/
骱	jpgj/
蜐	jpil/
讦	jpyg/
喈	jpkb/
楷	jpmb/
悈	jpxc/
湝	jpdb/
岊	jpbu/
㛃	jpfn/
灸	jqjh/
韭	jqfa/
舅	jqjl/
咎	jqwk/
臼	jqpa/
鹫	jqwn/
疚	jqbj/
氿	jqdj/
阄	jqmd/
桕	jqmj/
隽	jrrn/
鹃	jrkn/
镌	jrjn/
锩	jrjv/
桊	jrjm/
扃	jshk/
颎	jsby/
掘	jtfi/
角	jtdy/
噘	jtkq/
攫	jtfy/
珏	jtwy/
谲	jtyk/
抉	jtfg/
傕	jtrv/
桷	jtmy/
觖	jtdg/
獗	jtqq/
劂	jtid/
砄	jtug/
㵐	jtdq/
𫔎	jtjk/
𫘝	jtmg/
局	juuk/
居	juug/
狙	juqq/
拒	jufj/
矩	juuj/
钜	jujj/
遽	juzu/
莒	juck/
踞	juzg/
桔	jumk/
驹	jumj/
锔	jujk/
掬	jufm/
苴	jucq/
炬	juhj/
咀	jukq/
椐	jumg/
鞫	jugk/
苣	jucj/
倨	jurg/
雎	juqv/
屦	juun/
疽	jubq/
榉	jumf/
窭	jubn/
龃	juvq/
醵	juyu/
砠	juuq/
踽	juzy/
犋	junb/
飓	jufb/
澽	judu/
弆	juqc/
泃	judj/
䴗	juon/
𬶋	juyj/
价	jxrj/
佳	jxrt/
伽	jxrk/
驾	jxlm/
镓	jxju/
痂	jxbk/
颊	jxjy/
葭	jxcy/
郏	jxje/
瘕	jxby/
铗	jxjj/
茄	jxck/
戛	jxbg/
胛	jxoj/
跏	jxzk/
袈	jxly/
槚	jxmb/
泇	jxdk/
𬂩	jxmj/
郡	jyye/
竣	jylw/
皲	jybp/
葰	jycw/
龟	jydd/
莙	jyck/
隽	jyrn/
鲪	jyyk/
䐃	jyoh/
咖	kakk/
咔	kakb/
㸆	kchf/
锎	kdjk/
闿	kdmj/
慨	kdxw/
锴	kdjb/
忾	kdxq/
剀	kdud/
嗑	kekm/
珂	kewk/
棵	kemg/
颏	kewy/
髁	kegg/
窠	kebg/
蝌	keid/
疴	kebk/
坷	ketk/
岢	keuk/
稞	kehg/
匼	kekk/
炣	kehk/
溘	kedm/
垦	kfgt/
闶	khmj/
堪	kjtb/
龛	kjrl/
阚	kjmw/
莰	kjcq/
戡	kjcg/
磡	kjul/
衎	kjrg/
崁	kjuq/
嵁	kjub/
墈	kjtl/
侩	kkry/
郐	kkre/
匡	klkw/
旷	klog/
诳	klyw/
夼	kldi/
洭	kldw/
硿	ksug/
圐	kukf/
夔	kvbw/
溃	kvdb/
喹	kvkt/
馈	kvub/
愦	kvxb/
骙	kvmt/
跬	kvzt/
悝	kvxl/
戣	kvbg/
岿	kvue/
蒉	kvcb/
喟	kvko/
暌	kvot/
𫠆	kvvy/
堃	kyft/
鹍	kyon/
醌	kyyb/
壸	kyty/
抠	kzfq/
芤	kzcv/
落	lack/
旯	laoj/
蝲	laid/
揦	lafd/
砬	laul/
淋	lbdm/
麟	lblf/
璘	lbwf/
霖	lbym/
赁	lbrb/
吝	lbwk/
潾	lbdf/
嶙	lbuf/
粼	lbmv/
遴	lbzf/
瞵	lbof/
翷	lbmx/
𬴊	lbmf/
酪	lcyk/
痨	lcbl/
落	lcck/
嫪	lcnp/
铹	lcjl/
荖	lccl/
涞	lddl/
崃	ldul/
俫	ldrl/
嘞	lekl/
棱	lgmw/
堎	lgtw/
朗	lhlo/
榔	lhme/
塱	lhlt/
桹	lhml/
蒗	lhcl/
稂	lhhl/
㮾	lhlm/
蓢	lhco/
理	liwl/
立	liwb/
粒	liml/
梨	lihm/
黎	lihu/
璃	liwn/
戾	lihq/
藜	licu/
笠	livl/
厘	liil/
厉	liiw/
犁	lihn/
隶	liyu/
骊	limd/
荔	licl/
澧	lidb/
俪	lird/
醴	liyb/
鬲	lial/
砺	liuw/
俚	lirl/
罹	lisv/
疠	libw/
篱	livn/
浬	lidl/
漓	lidn/
呖	likl/
蠡	lihi/
蜊	liid/
溧	lidm/
鲡	liyd/
唳	likq/
醨	liyn/
鹂	liln/
粝	limw/
黧	lihh/
缡	lisn/
傈	lirm/
疬	libl/
跞	lizl/
雳	liyl/
猁	liqd/
蓠	licn/
篥	livm/
浰	lidd/
㰀	limu/
𫵷	liul/
拦	ljfl/
澜	ljdj/
榄	ljmj/
婪	ljmn/
罱	ljsg/
襕	ljpj/
漤	ljdn/
𬒗	ljuj/
陵	lkew/
翎	lkrx/
聆	lkes/
泠	lkds/
伶	lkrs/
苓	lkcs/
呤	lkks/
羚	lkys/
瓴	lkrw/
鲮	lkyw/
舲	lkvs/
棱	lkmw/
柃	lkms/
〇	lkvv/
酃	lkye/
鸰	lkrn/
凉	lldx/
良	lldg/
粱	lldm/
椋	llmx/
俍	llrl/
辌	llix/
𬜯	llcl/
镰	lmjj/
涟	lmdi/
琏	lmwi/
殓	lmdq/
蔹	lmcw/
梿	lmmi/
潋	lmdw/
裣	lmpq/
瑓	lmwj/
浰	lmdd/
𬶠	lmyj/
撂	lnfk/
疗	lnbl/
寥	lnbp/
髎	lngp/
橑	lnmx/
镣	lnjx/
漻	lndp/
蹽	lnzx/
鹩	lndn/
咯	lokk/
啰	lokx/
骡	lomx/
萝	locx/
雒	lowv/
蠃	lowi/
泺	lodl/
荦	locn/
漯	lodx/
捋	lofc/
蓏	locg/
裂	lpdy/
洌	lpdd/
趔	lptd/
峛	lpud/
䴕	lpdn/
刘	lqwd/
琉	lqwi/
浏	lqdd/
榴	lqmt/
鎏	lqdj/
馏	lqut/
镏	lqjt/
锍	lqji/
飗	lqft/
瑬	lqdy/
珋	lqwe/
碌	lquu/
罶	lqst/
鹠	lqpn/
栾	lrwm/
銮	lrwj/
娈	lrwn/
挛	lrwu/
脔	lrwr/
孪	lrwz/
陇	lsel/
垄	lslt/
砻	lslu/
咙	lskl/
窿	lsbu/
昽	lsol/
弄	lswc/
漋	lsdu/
𬕂	lsvb/
䂮	ltfu/
陆	luej/
露	luyk/
卤	lubx/
虏	luhl/
掳	lufl/
庐	lugh/
橹	lumo/
颅	luby/
渌	ludu/
赂	lubk/
潞	ludk/
鲈	luyu/
菉	lucu/
蕗	luck/
箓	luvu/
栌	lumu/
漉	ludl/
辘	luil/
逯	luzu/
鸬	lubn/
甪	lupy/
琭	luwu/
轳	luiu/
勠	luxl/
稑	luht/
澛	ludo/
𬬻	luju/
捋	lvfc/
履	lvuw/
侣	lvrk/
缕	lvsn/
闾	lvmk/
膂	lvfo/
稆	lvhk/
偻	lvrn/
罍	lwtf/
酹	lwyc/
耒	lwfm/
诔	lwyl/
藟	lwct/
缧	lwsx/
礌	lwut/
仑	lyrb/
溇	lzdn/
剅	lzdd/
𦝼	lzon/
蟆	maid/
摩	magu/
闵	mbmw/
愍	mbmx/
湣	mbdo/
黾	mbkd/
鳘	mbpy/
忞	mbwx/
锚	mcjt/
贸	mcpb/
卯	mcpe/
昴	mcoe/
茂	mccw/
峁	mcue/
铆	mcje/
懋	mcmx/
袤	mcym/
茆	mcce/
芼	mccm/
瞀	mcmo/
蟊	mcmi/
眊	mcom/
懑	mfdx/
蒙	mgcu/
獴	mgqu/
勐	mgzl/
甍	mgcw/
朦	mgou/
蠓	mgiu/
瞢	mgco/
幪	mgju/
蜢	mgim/
艨	mgvu/
㠓	mguu/
鹲	mgcn/
芒	mhcw/
氓	mhwm/
邙	mhwe/
牻	mhnp/
厖	mhip/
蜜	mibi/
幂	mibj/
芈	micf/
靡	migf/
醚	miym/
糜	migm/
弭	mige/
祢	mipx/
汨	mido/
蓂	micl/
宓	mibb/
脒	miom/
縻	migx/
洣	midm/
嘧	miku/
漫	mjdy/
瞒	mjol/
谩	mjyy/
镘	mjjy/
颟	mjcy/
埋	mjtl/
𬜬	mjck/
暝	mkol/
溟	mkdl/
绵	mmsj/
勉	mmdl/
冕	mmoe/
沔	mmdg/
眄	mmog/
勔	mmml/
腼	mmom/
湎	mmdm/
渑	mmdd/
眇	mnou/
藐	mnce/
鹋	mncn/
缪	mnsp/
磨	mogu/
麽	mogm/
抹	mofw/
默	molq/
沫	modw/
摹	mocu/
殁	modu/
茉	mocw/
漠	modd/
貊	movb/
蓦	mocm/
瘼	mobd/
耱	molu/
无	moay/
脉	mooy/
嫫	mond/
靺	mogw/
篾	mpvd/
暮	muco/
牧	munw/
模	mumd/
慕	mucx/
幕	mucj/
募	mucl/
牡	munt/
呒	mukw/
毪	mumn/
𬭁	mujm/
梅	mwmm/
酶	mwym/
媒	mwnm/
媚	mwno/
郿	mwue/
镅	mwjo/
袂	mwpg/
浼	mwde/
楣	mwmo/
鹛	mwun/
渼	mwdd/
糜	mwgm/
媄	mwnd/
瑂	mwwo/
嵋	mwuo/
缪	mzsp/
呐	nakn/
镎	naju/
臑	ncoe/
峱	ncqu/
艿	ndcn/
鼐	ndno/
耏	ndep/
呢	nikb/
溺	nidg/
睨	nioe/
伲	nirb/
旎	nifb/
鲵	niye/
囡	njkn/
蝻	njig/
甯	nkby/
泞	nkdd/
捻	nmfx/
辇	nmfi/
拈	nmfv/
廿	nmca/
鲇	nmyv/
搦	nofg/
镊	npjy/
颞	npey/
臬	npzm/
蘖	npcm/
嗫	npky/
陧	npet/
菍	npcx/
拗	nqfl/
努	nunl/
奴	nuny/
驽	nunm/
孥	nunz/
砮	nunu/
胬	nunr/
区	oukx/
殴	ouqu/
瓯	ouqw/
𠙶	oukl/
舥	pavb/
牝	pbnb/
颦	pbvu/
姘	pbnk/
匏	pcdb/
疱	pcbb/
湃	pddf/
徘	pdrf/
砰	pgup/
硼	pguo/
鹏	pgon/
膨	pgop/
芃	pgcf/
椪	pgmy/
搒	pgff/
堋	pgto/
淜	pgdo/
鳑	phyf/
劈	piud/
啤	piku/
辟	piux/
丕	piba/
疲	pibp/
痞	pibk/
坯	pitp/
嚭	pitk/
噼	pikx/
譬	piuk/
圮	pitj/
邳	pibe/
裨	pipu/
郫	pipe/
陴	pieu/
鼙	pitu/
伾	pirp/
甓	piuw/
睥	piou/
椑	pimu/
砒	piub/
蚍	piib/
仳	pirb/
淠	pidw/
纰	pisb/
鲏	piyp/
䴙	piun/
𬳵	pimp/
叛	pjby/
磐	pjvu/
泮	pjdb/
槃	pjvm/
襻	pjpu/
胖	pjob/
苹	pkcp/
鲆	pkyp/
冯	pkdm/
俜	pkrk/
泙	pkdp/
荓	pkck/
涄	pkdk/
骈	pmmk/
便	pmrg/
楩	pmmg/
扁	pmhc/
㛹	pmng/
瓢	pnxg/
剽	pnxd/
骠	pnmu/
殍	pndz/
薸	pncu/
婆	podn/
钷	pojk/
泊	podb/
皤	pobt/
桲	pomz/
朴	pomb/
繁	popx/
䥽	pojy/
蒲	pucf/
浦	pudf/
溥	pudc/
瀑	pudu/
圃	pukf/
镨	pujo/
堡	purt/
镤	pujf/
菩	puck/
匍	pubf/
潽	pudo/
脯	puof/
墣	putf/
氆	pumo/
旆	pwfj/
帔	pwjp/
霈	pwyj/
抔	pzfb/
禽	qbrn/
衾	qbry/
芹	qbcj/
溱	qbdh/
揿	qbfq/
嗪	qbkh/
芩	qbcv/
梣	qbmv/
螓	qbih/
檎	qbmn/
慬	qbxw/
吣	qbkx/
锓	qbjy/
棋	qimb/
漆	qidu/
弃	qiwc/
岂	qiuj/
欺	qicq/
砌	qiud/
琪	qiwb/
契	qifd/
淇	qidb/
泣	qidl/
琦	qiwk/
祁	qipe/
乞	qipv/
栖	qimx/
戚	qiwx/
祇	qipu/
炁	qiwh/
汽	qidq/
柒	qidm/
祈	qipj/
沏	qidd/
祺	qipb/
崎	qiuk/
讫	qiyv/
杞	qimj/
蕲	qicj/
萁	qicb/
岐	qiuv/
嘁	qikx/
凄	qidn/
碛	qiub/
畦	qitt/
綦	qicx/
玘	qiwj/
耆	qilo/
芪	qicu/
亓	qiaw/
跂	qizv/
埼	qitk/
棨	qihm/
颀	qijy/
葺	qice/
磜	qiuu/
圻	qitj/
汔	qidv/
蹊	qizd/
憩	qiux/
萋	qicn/
亟	qila/
蜞	qiib/
郪	qiue/
俟	qiru/
稽	qiho/
缉	qise/
鲯	qiyb/
䓫	qick/
𨙸	qive/
𬨂	qiiu/
氰	qkqo/
罄	qktf/
蜻	qkio/
亲	qklm/
檠	qkcm/
庼	qkgy/
倩	qkro/
苘	qkck/
羟	qlyj/
樯	qlmk/
镪	qlji/
锖	qljo/
襁	qlpi/
蔃	qlci/
欠	qmdr/
铅	qmjk/
牵	qmdn/
潜	qmdo/
迁	qmzq/
钳	qmjg/
嵌	qmuq/
钤	qmjv/
芡	qmcq/
歉	qmjq/
仟	qmrq/
褰	qmby/
汧	qmdk/
谴	qmyl/
荨	qmcc/
搴	qmbu/
愆	qmrx/
佥	qmra/
椠	qmim/
悭	qmxt/
蒨	qmco/
岍	qmuk/
磏	qmuj/
纤	qmsq/
掮	qmfo/
伣	qmrj/
墘	qmtv/
𬘬	qmso/
翘	qnyx/
樵	qnmh/
鞘	qngo/
谯	qnyh/
侨	qnrl/
诮	qnyo/
橇	qnmm/
峭	qnuo/
劁	qnrd/
硚	qnul/
雀	qnxv/
憔	qnxh/
硗	qnuw/
鞒	qngl/
惬	qpxj/
郄	qpxe/
裘	qqqy/
楸	qqmh/
遒	qqzy/
鼽	qqzj/
泅	qqdr/
俅	qqrq/
赇	qqbq/
龟	qqdd/
蚯	qqiq/
蝤	qqiy/
犰	qqqj/
巯	qqji/
鹙	qqhn/
訄	qqjk/
𨱇	qqjq/
拳	qrju/
醛	qryw/
颧	qrcy/
铨	qrjw/
痊	qrbw/
辁	qriw/
棬	qrmv/
鳈	qryu/
蛩	qsgi/
銎	qsgj/
䓖	qscl/
榷	qtmv/
阕	qtmt/
碏	qtuo/
埆	qtty/
𬒈	qtxu/
娶	quen/
趋	qute/
躯	quuq/
朐	quoj/
劬	qujl/
胠	quoq/
袪	qupq/
苣	qucj/
蘧	qucu/
阒	qumq/
鸲	qujn/
璩	quwu/
蠼	quiy/
焌	quhw/
氍	quom/
坥	qutq/
蛐	quiq/
磲	quum/
灈	qudv/
竘	qulj/
䓛	quci/
拤	qxfb/
仁	rfre/
衽	rfpw/
仞	rfrr/
讱	rfyr/
纴	rfsw/
葚	rfcb/
蒻	rocg/
爇	roch/
荣	rscm/
戎	rsgu/
茸	rsce/
濡	rude/
褥	rupc/
襦	rupe/
蓐	rucc/
洳	rudk/
蠕	ruie/
溽	rudc/
薷	ruce/
蕊	rvcx/
蕤	rvcu/
糅	rzmm/
潵	sadw/
挲	sadu/
璱	sewb/
颡	shyy/
寺	sitc/
嗣	sikk/
巳	sikv/
嘶	sikj/
俟	siru/
笥	sivk/
汜	sids/
伺	sirk/
咝	siks/
涘	sidu/
缌	sisx/
澌	sidj/
蛳	siij/
飔	sifx/
鸶	sisn/
㟃	siuk/
楒	simx/
毵	sjsm/
唆	sokw/
葰	socw/
溹	sodx/
唢	sokb/
嗍	soko/
莎	socu/
桫	somu/
挲	sodu/
耸	ssre/
嵩	ssuk/
讼	ssyg/
凇	ssdg/
𪨊	ssur/
忪	ssxg/
诉	suyi/
肃	suyb/
稣	suyh/
谡	suyw/
愫	suxx/
涑	sudu/
傃	surx/
鹔	suyn/
蹜	suzb/
窣	subu/
僳	surm/
隋	sveo/
燧	svhu/
尿	svuu/
隧	sveu/
邃	svzu/
眭	svot/
𫟦	sviu/
蒐	szcg/
嗽	szkq/
擞	szfw/
锼	szjy/
嗾	szku/
塌	tatx/
拓	tafu/
牠	tany/
趿	tazj/
蹋	tazx/
闼	tamd/
阘	tamx/
褟	tapx/
鿎	taud/
涛	tcdc/
洮	tcdv/
滔	tcdj/
叨	tckd/
焘	tcfh/
梼	tcmc/
绹	tcsf/
啕	tckf/
𫘦	tcmf/
肽	tdot/
邰	tdse/
酞	tdyt/
薹	tdct/
炱	tdsh/
滕	tgou/
縢	tgox/
螣	tgoi/
䲢	tgoy/
烫	thdh/
棠	thxm/
淌	thdk/
塘	thtk/
樘	thmt/
傥	thrx/
镋	thjx/
螗	thik/
鄌	thge/
铴	thjp/
䣘	thxe/
替	tifo/
蹄	tizj/
惕	tixw/
嚏	tikz/
荑	ticy/
鹈	tibn/
绨	tisd/
鳀	tiyz/
擿	tifg/
倜	tirk/
逖	tizh/
䏲	tiod/
𫘨	timz/
探	tjfm/
坦	tjtd/
瘫	tjbv/
炭	tjuh/
潭	tjdu/
毯	tjmh/
镡	tjju/
惔	tjxh/
忐	tjux/
倓	tjrh/
锬	tjjh/
澹	tjdk/
榃	tjmt/
磹	tjuu/
珽	tkww/
渟	tkdd/
蜓	tkiw/
莛	tkcw/
颋	tkzy/
桯	tkmw/
侹	tkrw/
烶	tkhw/
舔	tmux/
忝	tmtx/
湉	tmdu/
殄	tmdp/
畋	tmtw/
沺	tmdt/
淟	tmdb/
晪	tmob/
盷	tmoy/
鲦	tnym/
粜	tnim/
朓	tnov/
迢	tnzk/
龆	tnvk/
驮	tomd/
拓	tofu/
佗	torb/
鼍	tokd/
椭	tomo/
柁	tomb/
柝	tomi/
箨	tovf/
圫	totq/
庹	togi/
𬶍	toyb/
帖	tpjv/
煓	trhe/
桐	tsmk/
僮	tsrl/
仝	tsrg/
潼	tsdl/
烔	tshk/
橦	tsml/
峒	tsuk/
洞	tsdk/
曈	tsol/
哃	tskk/
鲖	tsyk/
峂	tsud/
𦒍	tslx/
兔	tudd/
屠	tuuo/
菟	tuct/
凃	tudm/
稌	tuhm/
葖	tucq/
𬳿	tumm/
煺	tvhg/
暾	tyow/
坉	tytt/
鲨	uady/
煞	uadh/
刹	uaxd/
唼	uakn/
挲	uadu/
稍	ucho/
劭	ucdl/
潲	ucdo/
芍	uccu/
筲	ucvo/
召	ucdk/
柖	ucmk/
赦	ueiw/
折	uefj/
奢	uedo/
佘	ueru/
歙	uerq/
畲	uert/
滠	uedy/
厍	ueii/
拾	uefk/
猞	ueqg/
𪨶	ueui/
什	ufru/
渗	ufdp/
侁	ufre/
莘	ufcx/
谌	ufyb/
瘆	ufbp/
甡	ufuu/
参	ufsp/
椹	ufmb/
胂	ufou/
呻	ufku/
矧	uful/
谂	ufyx/
鲹	ufyp/
葚	ufcb/
娠	ufni/
棽	ufmv/
𬳽	ufme/
昇	ugoc/
晟	ugoi/
甥	ugul/
嵊	ugur/
眚	uguo/
乘	ugqr/
赏	uhxb/
裳	uhxy/
觞	uhdp/
垧	uhtk/
诗	uiyc/
石	uiak/
实	uibd/
试	uiyg/
士	uiua/
失	uipf/
氏	uipv/
饰	uiuj/
尸	uikp/
施	uify/
识	uiyv/
矢	uipd/
嗜	uiko/
谥	uiym/
誓	uifk/
释	uicf/
恃	uixc/
侍	uirc/
仕	uirt/
逝	uizj/
蚀	uiui/
豕	uiau/
匙	uiob/
噬	uikr/
奭	uidb/
祏	uipu/
拭	uifg/
驶	uimu/
莳	uicc/
似	uirr/
筮	uivr/
舐	uiuu/
湜	uidz/
栻	uimg/
贳	uiub/
蓍	uico/
螫	uiii/
酾	uiyd/
媞	uinz/
什	uiru/
鼫	uiju/
鸤	uiun/
嘘	uiky/
峙	uiuc/
殖	uidq/
襫	uipb/
鲺	uiyi/
邿	uite/
浉	uidj/
䏡	uiou/
䴓	uibn/
𫚕	uiyj/
𬤊	uiyz/
杉	ujmp/
煽	ujhx/
膻	ujod/
赡	ujbk/
骟	ujmx/
讪	ujyu/
禅	ujpu/
剡	ujhd/
鳝	ujyk/
鄯	ujye/
芟	ujcu/
晱	ujoh/
姗	ujnc/
潸	ujdo/
单	ujbu/
栅	ujmc/
烻	ujhv/
墡	ujtk/
𫮃	ujtu/
衰	ukyv/
泷	uldl/
鹴	ulyn/
漴	uldu/
槊	uonm/
妁	uonu/
闩	urma/
树	uumc/
术	uumd/
叔	uuuy/
梳	uumi/
孰	uuww/
署	uuso/
塾	uuwt/
恕	uunx/
庶	uugh/
漱	uudq/
殊	uudw/
戍	uuwd/
殳	uujy/
曙	uuoo/
薯	uuco/
枢	uumq/
菽	uucy/
澍	uudc/
倏	uurq/
摅	uufx/
腧	uuod/
纾	uusy/
秫	uuhu/
墅	uult/
沭	uudu/
婌	uuny/
陎	uuew/
毹	uurm/
鄃	uure/
𬬸	uuju/
说	uvyx/
瘦	uzby/
守	uzbc/
兽	uzbk/
授	uzfy/
艏	uzvz/
闸	vamj/
札	vamv/
栅	vamc/
咤	vakq/
揸	vafd/
楂	vamd/
哳	vakj/
喳	vakd/
霅	vayk/
拃	vafv/
咋	vakv/
蚱	vaiv/
鲊	vayv/
奓	vadx/
溠	vadg/
馇	vaud/
挓	vafq/
喋	vakm/
䃎	vaux/
鲝	vayy/
昭	vcok/
着	vcyo/
沼	vcdk/
曌	vcog/
旐	vcfv/
𬬿	vcjk/
𬶐	vcyv/
宅	vdbq/
寨	vdbm/
瘵	vdbu/
祭	vdxu/
择	vdff/
哲	vefk/
辙	veiw/
蛰	vefi/
赭	veio/
晢	vefo/
詟	velk/
䗪	vegi/
帧	vfjb/
针	vfju/
诊	vfyp/
鸩	vfbn/
赈	vfbi/
榛	vfmh/
桢	vfmb/
疹	vfbp/
胗	vfop/
禛	vfpb/
畛	vftp/
瑧	vfwh/
鬒	vfeb/
葴	vfck/
袗	vfpp/
揕	vffb/
蓁	vfch/
纼	vfsl/
郑	vgbe/
筝	vgvy/
钲	vgjv/
峥	vguy/
拯	vgfi/
诤	vgyy/
彰	vhlp/
鄣	vhle/
樟	vhmu/
漳	vhdu/
瘴	vhbu/
幛	vhju/
仉	vhrj/
暲	vhou/
治	vidk/
直	viuq/
支	viuy/
致	vigw/
置	visq/
汁	vidu/
智	viuo/
执	vifw/
掷	vife/
织	visv/
跖	vizu/
植	vimq/
滞	vidj/
侄	virt/
秩	vihf/
旨	vibo/
栀	vimv/
徵	virw/
址	vitv/
陟	vieu/
窒	vibt/
肢	viov/
雉	viuv/
痔	vibc/
芷	vicv/
挚	vifu/
祉	vipv/
沚	vidv/
栉	vime/
卮	viiv/
畤	vitc/
郅	vige/
稚	vihv/
禔	vipz/
殖	vidq/
峙	viuc/
絷	vifx/
鸷	vifn/
摭	vifh/
铚	vijt/
帜	vijv/
豸	vipp/
骘	viem/
踬	vizb/
蜘	viik/
蛭	viit/
埴	vitq/
踯	vize/
贽	vifb/
锧	vijb/
桎	vimt/
黹	viyx/
滍	vidi/
跱	vizc/
忮	vixv/
稙	vihq/
疐	viuz/
识	viyv/
胝	viou/
晊	viot/
庤	vigc/
梽	vimx/
榰	vimo/
𬃊	vimb/
詹	vjdk/
栈	vjmj/
毡	vjmv/
湛	vjdb/
崭	vjuj/
辗	vjiy/
飐	vjfv/
栴	vjmd/
谵	vjyk/
搌	vjfy/
𫗴	vjud/
妆	vlln/
壮	vllt/
戆	vllx/
拙	vofi/
酌	voyu/
叕	voyy/
擢	vofv/
濯	vodv/
焯	vohu/
涿	vodu/
浞	vodz/
棁	vomx/
䓬	vocu/
䦃	vojo/
𬸦	vofn/
馔	vrug/
颛	vruy/
僎	vrrg/
仲	vsrv/
盅	vsvm/
锺	vsjv/
舯	vsvv/
朱	vupw/
渚	vudo/
助	vuql/
驻	vumv/
诛	vuyw/
株	vumw/
铢	vujw/
箸	vuvo/
蛀	vuiv/
邾	vupe/
茱	vucw/
竺	vuve/
洙	vudw/
炷	vuhv/
伫	vurv/
苎	vucv/
槠	vumo/
舳	vuvy/
柷	vumx/
麈	vulv/
侏	vurw/
杼	vumy/
翥	vulx/
疰	vubv/
躅	vuzi/
蠋	vuii/
橥	vuqm/
术	vumd/
瘃	vubu/
𬣞	vuyv/
骓	vvmv/
缒	vvsl/
洲	vzdv/
皱	vzdp/
昼	vzid/
诌	vzye/
酎	vzyc/
绉	vzse/
辀	vziv/
啁	vzkk/
赒	vzbk/
鸼	vzvn/
妯	vzny/
娲	wann/
畖	watg/
玟	wfww/
汶	wfdw/
炆	wfhw/
辒	wfim/
阌	wfmy/
紊	wfwx/
刎	wfwd/
榅	wfmm/
芠	wfcw/
鳁	wfym/
𫘜	wfmw/
蕹	wgcv/
鹟	wggn/
忘	whwx/
亡	whwv/
妄	whwn/
罔	whkw/
弯	wjwg/
绾	wjsl/
腕	wjov/
皖	wjby/
剜	wjbd/
宛	wjbv/
豌	wjdv/
莞	wjcy/
脘	wjoy/
芄	wjcw/
婠	wjnl/
琬	wjwv/
塆	wjtg/
𬇕	wjdw/
涡	wodn/
渥	wodt/
偓	wort/
蜗	woin/
硪	wouw/
涴	wodv/
乌	wupa/
误	wuyt/
唔	wukk/
雾	wuyl/
务	wuwl/
兀	wuae/
午	wupu/
呜	wukw/
巫	wugr/
恶	wuyx/
诬	wuyr/
邬	wuwe/
寤	wubk/
庑	wugw/
侮	wurm/
忤	wuxw/
鹜	wumn/
鼯	wujk/
晤	wuok/
骛	wumm/
杌	wumw/
鹀	wugn/
梧	wumk/
妩	wunw/
圬	wutk/
芴	wucw/
洿	wudk/
鋈	wudj/
屼	wuuw/
珷	wuwv/
鹉	wuyn/
仵	wurw/
珸	wuwk/
牾	wunk/
峿	wuuk/
𣲘	wudw/
微	wwrj/
喂	wwky/
伪	wwrw/
唯	wwkv/
围	wwkw/
委	wwhn/
畏	wwty/
煨	wwhy/
隈	wwey/
蔚	wwcc/
苇	wwcw/
炜	wwhw/
尉	wwuc/
慰	wwux/
纬	wwsw/
萎	wwcn/
鲔	wwyo/
渭	wwdo/
玮	wwww/
帏	wwjw/
薳	wwcy/
巍	wwug/
猬	wwqo/
鳚	wwyc/
潍	wwdv/
亹	wwwq/
闱	wwmw/
偎	wwry/
诿	wwyn/
隗	wweg/
溦	wwdj/
沩	wwdw/
硙	wwuj/
崴	wwun/
逶	wwzn/
碨	wwuy/
煟	wwho/
琟	wwwv/
峗	wwuv/
螱	wwui/
鳂	wwyy/
𬀩	wwow/
𬱟	wwdy/
𬶏	wwyv/
薪	xbcj/
欣	xbjq/
鑫	xbjj/
歆	xblq/
镡	xbju/
囟	xbpx/
伈	xbrx/
莘	xbcx/
奚	xivd/
溪	xidd/
惜	xixo/
悉	xicx/
曦	xiok/
玺	xidy/
汐	xidx/
熄	xihx/
嘻	xikk/
檄	ximw/
铣	xije/
熙	xiih/
羲	xiyk/
晞	xioj/
烯	xihj/
禧	xipk/
犀	xiun/
隰	xieh/
豨	xiuj/
咥	xikt/
郤	xige/
谿	xivg/
歙	xirq/
牺	xinx/
禊	xipd/
翕	xirx/
觋	xigj/
僖	xirk/
熹	xith/
醯	xiym/
饩	xiuq/
皙	ximb/
郗	xixe/
憙	xitx/
唏	xikj/
螅	xiix/
舄	xijh/
浠	xidj/
枲	xism/
傒	xird/
肸	xiou/
酅	xiue/
屃	xiub/
屣	xiuz/
嶲	xiuk/
蓰	xicz/
觿	xidk/
蹊	xizd/
舾	xivx/
菥	xicj/
潟	xidh/
鳛	xiyb/
穸	xibx/
裼	xipw/
鼷	xijd/
绤	xisg/
阋	xime/
樨	ximn/
爔	xihk/
巇	xiug/
俙	xirj/
恓	xixx/
粞	ximx/
饻	xiuy/
𠅤	xiwx/
𫘬	ximd/
𬭳	xijk/
兴	xkxb/
邢	xkke/
刑	xkkd/
腥	xkou/
饧	xkup/
骍	xkmx/
惺	xkxu/
婞	xkng/
荥	xkcu/
悻	xkxg/
钘	xkjk/
硎	xkud/
𫰛	xknj/
乡	xlvp/
巷	xlgs/
橡	xlmu/
湘	xldo/
祥	xlpy/
详	xlyy/
襄	xlyf/
庠	xlgy/
骧	xlmf/
鲞	xljy/
瓖	xlwf/
珦	xlwk/
葙	xlco/
𬙋	xlsf/
咸	xmwk/
限	xmeg/
献	xmuq/
陷	xmej/
酰	xmye/
氙	xmqu/
衔	xmrj/
腺	xmou/
羡	xmyq/
霰	xmyw/
纤	xmsq/
娴	xmnm/
籼	xmmu/
舷	xmvx/
岘	xmuj/
苋	xmcj/
冼	xmde/
燹	xmuh/
狝	xmqx/
暹	xmzv/
痫	xmbm/
伭	xmrx/
缐	xmsu/
跹	xmzq/
猃	xmqq/
孅	xmnj/
鹇	xmmn/
莶	xmcq/
挦	xmfc/
禒	xmpu/
㬎	xmoh/
𪾢	xmoj/
𫍯	xmyk/
𬸣	xmbn/
削	xnxd/
枵	xnmk/
咲	xnkt/
崤	xnuo/
啸	xnkb/
筱	xnvw/
骁	xnmw/
潇	xndb/
虓	xnjj/
嚣	xnkk/
淆	xndo/
哓	xnkw/
哮	xnkz/
皛	xnbb/
洨	xndf/
涍	xndz/
蟏	xnib/
敩	xnxw/
滧	xndw/
𫍲	xnyy/
邪	xpye/
卸	xpve/
挟	xpfj/
协	xpub/
泻	xpdy/
泄	xpdu/
偕	xprb/
谐	xpyb/
胁	xpob/
解	xpdn/
楔	xpmd/
榭	xpmc/
亵	xpyw/
绁	xpsu/
撷	xpfy/
絜	xpfx/
渫	xpdm/
偰	xprd/
廨	xpgn/
瀣	xpdj/
薢	xpcn/
揳	xpfd/
躞	xpzy/
榍	xpmo/
㙦	xprt/
𬹼	xpvj/
咻	xqkm/
脩	xqro/
滫	xqdo/
珛	xqwo/
馐	xqui/
鸺	xqrn/
宣	xrbd/
璇	xrwz/
渲	xrdd/
玹	xrwx/
烜	xrhd/
瑄	xrwd/
漩	xrdz/
券	xrjd/
儇	xrry/
晅	xrod/
眩	xrox/
翾	xrsx/
咺	xrkd/
琄	xrwo/
痃	xrbx/
暶	xroz/
𫍽	xryy/
𫓶	xrjo/
𫠊	xrmx/
汹	xsdx/
诇	xsyk/
谑	xtye/
茓	xtcb/
峃	xtxu/
叙	xury/
绪	xuso/
诩	xuyx/
圩	xuty/
吁	xuky/
婿	xuno/
煦	xuoh/
媭	xupn/
勖	xuol/
顼	xuwy/
蓿	xucb/
盱	xuoy/
欻	xuhq/
畜	xuxt/
糈	xumo/
洫	xudm/
湑	xudo/
魆	xugl/
谞	xuyo/
珝	xuwx/
浒	xudw/
㳚	xudd/
𦈡	xuse/
𬣙	xuyy/
匣	xxkj/
辖	xxik/
暇	xxoy/
叚	xxuy/
狎	xxqj/
硖	xxuj/
厦	xxiw/
巡	xyzv/
讯	xyyu/
询	xyyo/
洵	xydo/
迅	xyzu/
徇	xyro/
郇	xybe/
蕈	xycu/
浔	xydc/
荨	xycc/
栒	xymo/
醺	xyyh/
鲟	xyyc/
獯	xyqh/
汛	xydu/
噀	xykg/
浚	xydw/
𫄸	xysh/
𬍤	xywc/
𬘓	xysi/
𬩽	xyee/
哑	yaky/
鸦	yayn/
衙	yark/
轧	yaiv/
蚜	yaiy/
猰	yaqd/
玡	yawy/
砑	yauy/
讶	yayy/
揠	yafn/
堐	yatt/
隐	ybex/
尹	ybep/
胤	ybeo/
殷	ybpu/
寅	ybbb/
茵	ybcy/
洇	ybdy/
铟	ybjy/
鄞	ybce/
喑	ybko/
垠	ybtg/
窨	ybbo/
訚	ybmk/
禋	ybpt/
龂	ybvj/
崟	ybuj/
嚚	ybkk/
慭	yblx/
夤	ybxb/
狺	ybqk/
蟫	ybiu/
溵	ybdu/
吲	ybkl/
硍	ybug/
歅	ybxq/
䲟	ybye/
𬤇	ybyt/
𬮱	ybmt/
姚	ycnv/
舀	ycvj/
曜	ycov/
谣	ycyf/
遥	yczf/
窈	ycbl/
吆	ycky/
肴	ycxo/
鹞	ycvn/
窅	ycbo/
铫	ycjv/
珧	ycwv/
疟	ycbe/
靿	ycgl/
侥	ycrw/
崾	ycun/
媱	ycnf/
㙘	yctn/
业	yela/
噎	yekb/
谒	yeyr/
掖	yefw/
曳	yeyp/
冶	yedk/
腋	yeow/
咽	yeky/
揶	yefe/
痒	yhby/
漾	yhdy/
羕	yhyy/
佯	yhry/
烊	yhhy/
飏	yhfp/
炀	yhhp/
疡	yhbp/
恙	yhyx/
鸯	yhyn/
咉	yhky/
意	yilx/
伊	yiry/
衣	yiwy/
医	yiku/
异	yisc/
裔	yiyk/
益	yibm/
邑	yikb/
奕	yiwd/
役	yiru/
夷	yiar/
疑	yibz/
倚	yirk/
忆	yixv/
遗	yizb/
怡	yixk/
噫	yikx/
议	yiyy/
胰	yioy/
溢	yidm/
驿	yimf/
埸	yitw/
疫	yibu/
刈	yixd/
钇	yijv/
懿	yitx/
颐	yiiy/
弋	yiyd/
薏	yicx/
毅	yilu/
诣	yiyo/
揖	yife/
彝	yihc/
贻	yibk/
轶	yiif/
镒	yijm/
祎	yipw/
羿	yixc/
佚	yirf/
弈	yiwc/
咿	yiky/
谊	yiyq/
燚	yihh/
臆	yiox/
镱	yijx/
沂	yidj/
扆	yihy/
峄	yiuf/
佾	yiro/
殪	yidb/
瘗	yibt/
绎	yisf/
苡	yicr/
挹	yifb/
迤	yizy/
缢	yism/
圯	yits/
饴	yiuk/
劓	yizd/
荑	yicy/
翌	yixl/
嶷	yiuz/
熠	yihb/
怿	yixf/
肄	yiby/
踦	yizk/
潩	yidg/
螠	yiim/
嗌	yikm/
漪	yidk/
舣	yivy/
裛	yiyb/
屹	yiuv/
旖	yifk/
簃	yivx/
嫕	yinx/
鹢	yibn/
勚	yiul/
呓	yikv/
蜴	yiiw/
眙	yiok/
癔	yibx/
洢	yidy/
悒	yixb/
廙	yigg/
杙	yimy/
宧	yibi/
扅	yihx/
㑊	yirb/
枍	yimk/
𫄷	yisx/
𫖮	yiuy/
𬟁	yicn/
𬬩	yijy/
𬺈	yivk/
沿	yjdk/
颜	yjwy/
腌	yjod/
炎	yjhh/
岩	yjuu/
彦	yjwp/
阎	yjmj/
闫	yjms/
艳	yjfb/
焰	yjhj/
晏	yjon/
淹	yjdd/
雁	yjiv/
嫣	yjnh/
檐	yjmk/
鄢	yjve/
俨	yjry/
阏	yjmd/
魇	yjig/
衍	yjrd/
甗	yjhw/
砚	yjuj/
筵	yjvv/
弇	yjrc/
赝	yjib/
湮	yjdt/
酽	yjyy/
琰	yjwh/
郾	yjke/
沇	yjdy/
滟	yjdb/
芫	yjcy/
谚	yjyp/
唁	yjkk/
黡	yjih/
胭	yjoy/
渰	yjdc/
墕	yjth/
掞	yjfh/
棪	yjmh/
戭	yjbg/
蝘	yjin/
鼹	yjjn/
厣	yjij/
崦	yjud/
䶮	yjlt/
漹	yjdh/
觃	yjjz/
𪩘	yjuq/
𫄧	yjsv/
𬙂	yjsb/
𬸘	yjkn/
营	ykck/
嬴	ykwn/
郢	ykke/
瑛	ykwy/
映	ykoy/
萤	ykci/
莺	ykcn/
婴	ykbn/
颍	ykby/
莹	ykcy/
媵	ykon/
膺	ykgo/
楹	ykmm/
萦	ykcx/
荧	ykch/
罂	ykbf/
荥	ykcu/
溁	ykdm/
滢	ykdy/
潆	ykdx/
蓥	ykcj/
茔	ykct/
媖	ykny/
䓨	ykcf/
愿	yrix/
员	yrkb/
园	yrky/
渊	yrdl/
垣	yrtd/
掾	yrfu/
鼋	yryd/
塬	yrtx/
沅	yrdy/
媛	yrny/
辕	yriy/
鸳	yrxn/
嫄	yrnx/
芫	yrcy/
垸	yrty/
涴	yrdv/
蜎	yrio/
眢	yrxo/
箢	yrvv/
羱	yryx/
𫘪	yrmx/
涌	ysdy/
俑	ysry/
鄘	ysge/
甬	yssy/
壅	yswt/
饔	yswg/
澭	ysdv/
墉	ysto/
喁	yskd/
恿	yssx/
埇	ysty/
鲬	ysyy/
曰	ytka/
乐	ytpx/
樾	ytml/
哕	ytkx/
钥	ytjo/
𬸚	ytqn/
雨	yuad/
预	yuyy/
御	yure/
瑜	yuwd/
愈	yurx/
逾	yuzd/
俞	yurd/
渔	yudy/
渝	yudd/
豫	yuyu/
愚	yutx/
裕	yupg/
育	yuwo/
瘀	yubd/
浴	yudg/
彧	yuga/
峪	yuug/
誉	yuxk/
榆	yumd/
鬻	yugg/
谕	yuyd/
欤	yuyq/
鹬	yumn/
阈	yuma/
愉	yuxd/
毓	yupi/
圉	yukg/
吁	yuky/
瑀	yuwy/
聿	yuyg/
盂	yuym/
煜	yuhl/
屿	yuuy/
庾	yugr/
鄅	yuye/
迂	yuzy/
禺	yutd/
淯	yudo/
窳	yubg/
遹	yuzk/
妪	yunq/
纡	yusy/
鹆	yugn/
俣	yurt/
钰	yujy/
雩	yuyk/
舁	yujc/
喁	yukd/
敔	yuww/
谀	yuyr/
腴	yuor/
燠	yuhd/
矞	yumk/
妤	yuny/
嵛	yuud/
熨	yuuh/
潏	yudk/
圄	yukk/
堉	yuto/
臾	yujr/
褕	yupd/
艅	yuvm/
揄	yufd/
燏	yuhk/
瘐	yubr/
龉	yuvk/
觎	yurj/
萸	yucr/
髃	yugd/
尉	yuuc/
蔚	yucc/
狳	yuqm/
伛	yurq/
蝓	yuid/
蓣	yucy/
㺄	yuqd/
蕴	yycm/
昀	yyoy/
妘	yyny/
赟	yywb/
氲	yyqm/
恽	yyxi/
缊	yysm/
筼	yyvb/
郓	yybe/
耘	yyly/
沄	yydy/
纭	yysy/
员	yykb/
馧	yyhm/
涢	yydb/
𫖳	yyyy/
游	yzdz/
呦	yzkl/
友	yzuy/
铀	yzjy/
佑	yzrk/
幼	yzyl/
邮	yzye/
酉	yzxa/
诱	yzyn/
悠	yzrx/
宥	yzbo/
攸	yzrw/
鱿	yzyy/
囿	yzko/
侑	yzro/
牖	yzpf/
铕	yzjo/
卣	yzbk/
猷	yzbq/
莠	yzcn/
羑	yzyj/
黝	yzll/
耰	yzlw/
槱	yzmh/
莜	yzcw/
蝤	yziy/
莸	yzcy/
蝣	yziz/
浟	yzdw/
匝	zakj/
拶	zafx/
遭	zczo/
燥	zchm/
躁	zczm/
唣	zckq/
𥖨	zcum/
哉	zdgk/
栽	zdgm/
灾	zdbh/
责	zefb/
咋	zekv/
赜	zeib/
箦	zevb/
舴	zevv/
甑	zgbw/
曾	zgbo/
鄫	zgbe/
罾	zgso/
综	zgsu/
䎖	zgbx/
藏	zhci/
奘	zhpd/
姿	zidn/
渍	zidb/
滋	zidy/
梓	zimx/
咨	zidk/
恣	zidx/
訾	zivk/
赀	zivb/
笫	zivd/
粢	zidm/
吱	zikv/
孳	zibz/
觜	zivy/
孜	zizw/
淄	zidt/
耔	zilz/
鼒	zico/
虸	ziiz/
锱	zijt/
鄑	ziye/
錾	zjij/
昝	zjwo/
拶	zjfx/
佐	zorg/
唑	zokr/
胙	zoov/
捽	zofu/
岞	zouv/
综	zssu/
粽	zsmu/
疭	zsbr/
枞	zsmr/
偬	zsrx/
珇	zuwq/
咀	zvkq/
鄹	zzee/
鲰	zzyy/
